hatka_farmera
11 10 3
0 0 0 0 0 0 0 0 0 0 0 
0 497 498 498 498 498 498 498 498 499 0 
0 497 498 498 498 498 498 498 498 499 0 
0 497 498 498 498 498 498 498 498 499 0 
0 497 498 498 498 498 498 498 498 499 0 
0 497 498 498 498 498 498 498 498 499 0 
0 497 498 498 498 498 498 498 498 499 0 
0 505 506 506 498 498 498 506 506 507 0 
0 0 0 0 506 506 506 0 0 0 0 
0 0 0 0 0 0 0 0 0 0 0 
0 0 0 0 0 0 0 0 0 0 0 
0 0 0 0 0 0 0 0 0 0 0 
0 0 0 0 0 0 0 0 0 0 0 
0 0 0 0 0 0 0 0 0 0 0 
0 0 0 0 0 0 0 0 0 0 0 
0 0 0 0 0 0 0 0 0 0 0 
0 0 0 0 0 0 0 0 0 0 0 
0 0 0 0 0 0 0 0 0 0 0 
0 0 0 0 0 0 0 0 0 0 0 
0 0 0 0 0 0 0 0 0 0 0 
0
0 0 0 0 732 733 0 0 761 0 0 
0 699 700 701 740 741 0 778 769 778 0 
0 0 0 0 0 0 0 786 0 786 0 
0 0 0 0 0 0 0 0 0 0 0 
0 936 0 0 0 0 0 0 0 0 0 
0 0 0 0 0 0 0 838 839 840 0 
0 755 0 0 0 0 0 846 847 848 0 
0 747 755 0 0 0 0 854 855 856 0 
0 0 0 0 0 0 0 0 0 0 0 
0 0 0 0 0 0 0 0 0 0 0 
1 1 1 1 1 1 1 1 1 1 1 
1 1 1 1 1 1 0 1 1 1 1 
1 0 0 0 0 0 0 1 0 1 1 
1 0 0 0 0 0 0 0 0 0 1 
1 1 0 0 0 0 0 0 0 0 1 
1 0 0 0 0 0 0 0 0 0 1 
1 1 0 0 0 0 0 1 1 0 1 
1 1 1 0 0 0 0 0 0 0 1 
1 1 1 1 0 0 0 1 1 1 1 
0 0 0 1 1 1 1 1 0 0 0 
3
6 8 goOut
5 8 goOut
4 8 goOut
0 0 0 0 0 0 0 0 0 0 0 
0 983 0 973 0 0 0 0 954 0 0 
0 0 0 0 0 0 0 0 0 0 0 
0 928 0 0 0 0 0 0 0 0 0 
0 0 0 0 0 0 0 0 0 0 0 
0 0 0 0 0 0 0 1012 0 0 0 
0 991 0 0 0 0 0 1020 1030 0 0 
0 999 0 0 0 0 0 0 0 0 0 
0 0 0 0 0 0 0 0 0 0 0 
0 0 0 0 0 0 0 0 0 0 0 
0 0 0 0 0 0 0 0 0 0 0 
0 0 0 0 0 0 0 0 0 0 0 
0 0 0 0 0 0 0 0 0 0 0 
0 0 0 0 0 0 0 0 0 0 0 
0 0 0 0 0 0 0 0 0 0 0 
0 0 0 0 0 0 0 0 0 0 0 
0 0 0 0 0 0 0 0 0 0 0 
0 0 0 0 0 0 0 0 0 0 0 
0 0 0 0 0 0 0 0 0 0 0 
0 0 0 0 0 0 0 0 0 0 0 
0
