miastoone
19 15 3
0 0 0 0 0 0 0 0 0 0 0 0 0 0 0 0 0 0 0 
0 498 498 498 498 498 498 498 498 498 498 498 498 498 498 498 498 0 0 
0 498 498 498 498 498 498 498 498 498 498 498 498 498 498 498 498 0 0 
0 498 498 498 498 498 498 498 498 498 498 498 498 498 498 498 498 0 0 
0 498 498 498 498 498 498 498 498 498 498 498 498 498 498 498 498 0 0 
0 498 498 498 498 498 498 498 498 498 498 498 498 498 498 498 498 0 0 
0 498 498 498 498 498 498 498 498 498 498 498 498 498 498 498 498 0 0 
0 498 498 498 498 498 498 498 498 498 498 498 498 498 498 498 498 0 0 
0 498 498 498 498 498 498 498 498 498 498 498 498 498 498 498 498 0 0 
0 498 498 498 498 498 498 498 498 498 498 498 498 498 498 498 498 0 0 
0 498 498 498 498 498 498 498 498 498 498 498 498 498 498 498 498 0 0 
0 498 498 498 498 498 498 498 498 498 498 498 498 498 498 498 498 0 0 
0 498 498 498 498 498 498 498 498 498 498 498 498 498 498 498 498 0 0 
0 0 0 0 0 0 0 0 0 0 0 0 0 0 0 0 0 0 0 
0 0 0 0 0 0 0 0 0 0 0 0 0 0 0 0 0 0 0 
1 1 1 1 1 1 1 1 1 1 1 1 1 1 1 1 1 1 1 
1 0 0 0 1 1 1 1 0 1 1 1 1 0 0 0 0 0 1 
1 0 0 0 1 1 1 1 1 1 0 0 1 0 0 0 0 0 1 
1 0 0 0 1 0 0 0 0 0 0 0 1 0 0 0 0 0 1 
1 1 1 1 1 0 0 0 0 0 0 0 1 1 1 1 1 0 1 
1 0 0 0 0 0 0 0 0 0 0 0 0 0 0 0 0 0 1 
1 0 0 0 0 0 0 0 0 0 0 0 0 0 0 0 0 0 1 
1 1 0 0 0 0 0 0 0 0 0 0 0 0 0 0 0 0 1 
1 0 0 0 0 0 0 0 0 0 0 0 0 0 0 0 0 0 1 
1 0 0 0 0 0 0 0 0 0 0 0 0 0 0 0 0 0 1 
1 0 0 0 1 0 0 0 0 0 0 0 0 0 1 0 0 0 1 
1 0 0 0 0 0 0 0 0 0 0 0 0 0 0 0 0 0 1 
1 0 0 0 0 0 0 0 0 0 0 0 0 0 0 0 0 0 1 
1 0 0 0 0 0 0 0 0 0 0 0 0 0 0 0 0 0 1 
1 1 1 1 1 1 1 1 1 1 1 1 1 1 1 1 1 1 1 
0
0 0 0 0 0 0 0 0 0 0 0 0 0 0 0 0 0 0 0 
0 1049 1050 1051 681 1033 1037 817 818 819 862 862 681 713 714 714 715 0 0 
0 1057 1058 1059 681 1041 1045 825 826 827 0 0 681 721 723 723 723 0 0 
0 0 0 0 681 0 0 838 839 840 0 0 681 0 0 0 0 0 0 
0 675 675 675 691 0 0 846 847 848 0 0 690 675 675 675 675 0 0 
0 0 0 0 0 0 0 854 855 856 0 0 0 0 0 0 0 0 0 
0 1052 0 0 0 0 0 0 0 0 0 0 0 0 0 0 0 0 0 
0 1060 0 0 0 0 0 0 0 0 0 0 0 0 0 0 857 0 0 
0 0 0 0 0 0 0 0 0 0 0 0 0 0 0 0 0 0 0 
0 0 0 0 725 0 0 0 0 0 0 0 0 0 725 0 0 0 0 
0 0 0 725 717 725 0 0 0 0 0 0 0 725 717 725 0 0 0 
0 0 0 0 725 0 0 0 0 0 0 0 0 0 725 0 0 0 0 
0 0 0 0 0 0 0 498 0 0 0 0 0 0 0 0 0 0 0 
0 0 0 0 0 0 0 0 498 498 498 0 0 0 0 0 0 0 0 
0 0 0 0 0 0 0 0 0 0 0 0 0 0 0 0 0 0 0 
0 0 0 0 0 0 0 0 0 0 0 0 0 0 0 0 0 0 0 
0 0 0 0 0 0 0 0 0 0 0 0 0 0 0 0 0 0 0 
0 0 0 0 0 0 0 0 0 0 0 0 0 0 0 0 0 0 0 
0 0 0 0 0 0 0 0 0 0 0 0 0 0 0 0 0 0 0 
0 0 0 0 0 0 0 0 0 0 0 0 0 0 0 0 0 0 0 
0 0 0 0 0 0 0 0 0 0 0 0 0 0 0 0 0 0 0 
0 0 0 0 0 0 0 0 0 0 0 0 0 0 0 0 0 0 0 
0 0 0 0 0 0 0 0 0 0 0 0 0 0 0 0 0 0 0 
0 0 0 0 0 0 0 0 0 0 0 0 0 0 0 0 0 0 0 
0 0 0 0 0 0 0 0 0 0 0 0 0 0 0 0 0 0 0 
0 0 0 0 0 0 0 0 0 0 0 0 0 0 0 0 0 0 0 
0 0 0 0 0 0 0 0 0 0 0 0 0 0 0 0 0 0 0 
0 0 0 0 0 0 0 0 0 0 0 0 0 0 0 0 0 0 0 
0 0 0 0 0 0 0 0 0 0 0 0 0 0 0 0 0 0 0 
0 0 0 0 0 0 0 0 0 0 0 0 0 0 0 0 0 0 0 
0
0 0 0 0 0 0 0 0 0 0 0 0 0 0 0 0 0 0 0 
0 0 0 0 0 0 0 0 0 0 0 0 989 666 714 0 661 0 0 
0 0 0 0 0 0 0 0 0 0 0 0 1005 0 0 0 0 0 0 
0 0 0 0 1064 0 0 0 0 0 0 0 0 0 0 0 0 0 0 
0 1011 0 1054 0 0 0 0 0 0 0 0 0 0 988 956 0 0 0 
0 0 0 0 0 0 0 0 0 0 0 0 0 0 0 0 0 0 0 
0 0 0 0 0 0 0 0 0 0 0 0 0 0 0 0 0 0 0 
0 0 0 0 0 0 0 0 0 0 0 0 0 0 0 0 0 0 0 
0 0 0 0 0 0 0 0 0 0 0 0 0 0 0 0 0 0 0 
0 0 0 0 0 0 0 0 0 0 0 0 0 0 0 0 0 0 0 
0 0 0 0 981 0 0 0 0 0 0 0 0 0 983 0 0 0 0 
0 0 0 0 0 0 0 0 0 0 0 0 0 0 0 0 0 0 0 
0 0 0 0 0 0 0 0 0 0 0 0 0 0 0 0 0 0 0 
0 0 0 0 0 0 0 0 0 0 0 0 0 0 0 0 0 0 0 
0 0 0 0 0 0 0 0 0 0 0 0 0 0 0 0 0 0 0 
0 0 0 0 0 0 0 0 0 0 0 0 0 0 0 0 0 0 0 
0 0 0 0 0 0 0 0 0 0 0 0 0 0 0 0 0 0 0 
0 0 0 0 0 0 0 0 0 0 0 0 0 0 0 0 0 0 0 
0 0 0 0 0 0 0 0 0 0 0 0 0 0 0 0 0 0 0 
0 0 0 0 0 0 0 0 0 0 0 0 0 0 0 0 0 0 0 
0 0 0 0 0 0 0 0 0 0 0 0 0 0 0 0 0 0 0 
0 0 0 0 0 0 0 0 0 0 0 0 0 0 0 0 0 0 0 
0 0 0 0 0 0 0 0 0 0 0 0 0 0 0 0 0 0 0 
0 0 0 0 0 0 0 0 0 0 0 0 0 0 0 0 0 0 0 
0 0 0 0 0 0 0 0 0 0 0 0 0 0 0 0 0 0 0 
0 0 0 0 0 0 0 0 0 0 0 0 0 0 0 0 0 0 0 
0 0 0 0 0 0 0 0 0 0 0 0 0 0 0 0 0 0 0 
0 0 0 0 0 0 0 0 0 0 0 0 0 0 0 0 0 0 0 
0 0 0 0 0 0 0 0 0 0 0 0 0 0 0 0 0 0 0 
0 0 0 0 0 0 0 0 0 0 0 0 0 0 0 0 0 0 0 
0
